@@@@@@@@@@@@@@@@@@@@@@@@@@@@@@@@@@@@@@@@@@@@@@@@@@@@@@@@@@@@@@@@@@@@@@@@@@@@@@@@
@                                                                              @
@                                                                              @
@                                                                              @
@                                                                              @
@                                                                              @
@                                           2                                  @
@                          1                                                   @
@                                                                              @
@                                                                              @
@                                                          2                   @
@                                                                              @
@                                                                              @
@                                                                              @
@                                                                              @
@                                                                              @
@                                                                              @
@                                                                              @
@                                                                              @
@                                     A                                        @
@                                                                              @
@                                                                              @
@                                                                              @
@@@@@@@@@@@@@@@@@@@@@@@@@@@@@@@@@@@@@@@@@@@@@@@@@@@@@@@@@@@@@@@@@@@@@@@@@@@@@@@@